11 23
8 8 8 8 8 8 8 8 8 8 8 8 8 8 8 8 8 8 8 8 8 8 8
8 0 1 0 0 0 1 0 0 0 0 0 0 0 0 0 0 0 1 0 1 0 8
8 0 0 0 1 0 1 0 1 1 1 1 1 1 1 0 1 0 1 0 1 0 8
8 1 1 0 1 0 1 0 0 1 0 0 0 0 1 0 1 0 1 0 1 0 8
8 0 1 0 1 0 1 1 0 0 0 1 1 1 1 0 1 0 1 0 0 0 8
8 0 1 1 1 0 0 1 0 1 0 0 0 0 0 0 1 0 0 0 1 0 8
8 0 0 0 1 1 0 0 0 1 1 1 1 0 1 0 1 1 1 1 1 0 8
8 0 1 0 0 0 0 0 0 0 0 0 1 0 1 0 0 0 0 0 0 0 8
8 1 1 0 0 1 1 1 1 0 1 0 1 0 0 0 1 0 1 0 1 0 8
8 0 0 0 0 5 1 0 0 0 1 0 1 0 0 0 1 0 1 0 1 0 8
8 8 8 8 8 8 8 8 8 8 8 8 8 8 8 8 8 8 8 8 8 8 8
2 2
4 23
